0,D,D,D,P,D
D,D,D,G,D,D
P,D,D,D,D,G
D,P,D,G,D,D
D,D,D,G,D,D
P,D,D,D,D,G

